00000eeeeees0000eeeees00000
00000np000ps0000np00ps00000
00000n00000s0000n0000s00000
00000n00000s0000n0000s00000
00000n00000s0000n0000s00000
00000n00000s0000n0000s00000
00000n00000s0000n0000s00000
00000n00000s0000n0000s00000
00000n00000s0000n0000s00000
00000n00000s0000n0000s00000
00000n00000s0000n0000s00000
00000n00000s0000n0000s00000
00000n00000s0000n0000s00000
00000n00000s0000n0000s00000
eeeeen00000s0000n0000s00000
00000000000s0000n0000s00000
00000000000sp00pn0000sp0000
00000000000eeeeen0000eeeeez
0,14
